1 1 1 1 1 1 1 1 1 1 1 1 1 1 1 1
1 5 5 5 5 5 5 5 5 5 5 5 5 5 5 5
1 0 0 0 0 0 0 0 0 0 0 0 0 0 9 0
5 0 0 0 0 0 0 9 0 0 0 0 0 0 0 0
0 0 0 0 0 0 0 0 0 0 0 0 0 0 0 0
0 0 0 0 0 0 0 0 0 0 0 0 0 0 9 0
1 0 0 0 0 0 0 0 0 0 0 0 0 0 9 0
1 0 0 0 9 0 0 0 0 0 0 0 0 0 0 0
1 0 0 0 0 0 0 0 1 8 8 8 8 8 8 8
1 0 0 0 0 0 0 9 1 7 7 7 7 7 7 7
1 0 0 0 0 0 0 9 1 2 2 2 2 2 2 2
1 0 0 0 9 0 0 9 1 2 2 2 2 2 2 2